1111111111111111111
1N0C00000000000C001
10000000000000000E1
10000111111111000P1
10000000000000000C1
1000C0000C000C00001
10000000000000000C1
1111111111111111111
