1111111111111111111111111
11000000001100000000000C1
11110C000111C000C00000001
110100000000000000000C001
1111111110110000011100001
1100000000110000011101111
1111011111111101110000001
1111011111111101110100001
1100000011010101110001111
11000C00000C0000110010001
1100000000000000110000001
1100000111010101111101111
11000P0000110000000E000C1
1111111111111111111111111