1111111111111
1P0N00000C0E1
1000N000N0001
10C0000000001
1111111111111
